%%%%%%%%
%      %
%.  P .%
%      %
%%%%%%%%