%%%%%%%%%%%%%%%%%%%%%%%%%%%%%%
%.                          .%
%       % % %%%%%% %%%%%%% % %
%       %        %     % %   %
% %%% %%%%% %%% %% %%%%% % % %
%   % % % %   %    %     %   %
% %%% % % % %%%%%%%% %%% %%% %
%       %     %%     % % %   %
% % % %%%%%%% %%%% %%% % % % %
% %           %%     %     % %
% % %%%%% % %%%% % %%% %%% % %
%   %     %      % %   % %%% %
%.   P                      .%
%%%%%%%%%%%%%%%%%%%%%%%%%%%%%%